###################
##$.$...$#$...$.$##
##.#.###.#.###.#.##
##$.$.$.$.$.$.$.$##
##.#.#.#####.#.#.##
##$.$#$..B..$#$.$##
####.#.##-##.#.####
!...$.$#IPC#$.$...!
####.#.#####.#.####
###$$.$.....$.$$###
###.##.#####.##.###
###.##$..@..$##.###
###.##.#####.##.###
###$..$..$..$..$###
###################
