###################
##.......#.......##
##.#.###.#.###.#.##
##...............##
##.#.#..###..#.#.##
##...##..#..##...##
###..#.......#..###
!.................!
###..#..###..#..###
##.......#.......##
##...##..@..##...##
###..#...#...#..###
##.....#...#.....##
##.....#...#.....##
###################
