###################
##$.$...$#$...$.$##
##.#.###.#.###.#.##
##$.$.$.$.$.$.$.$##
##.#.#.#####.#.#.##
##$.$#$..$..$#$.$##
####.#.##-##.#.####
!...$.$#I$C#$.$...!
####.#.#####.#.####
###$$.$.....$.$$###
###.##.#####.##.###
###.##$.....$##.###
###.##.#####.##.###
###$..$..$..$..$###
###################