###################
##.......#.......##
##.#.###.#.###.#.##
##...............##
##.#.#..###..#.#.##
##...#.......#...##
###..#.##-##.#..###
!......#...#......!
###..#.#####.#..###
##...............##
##...###.@.###...##
###..#...#...#..###
##.....#...#.....##
##.....#...#.....##
###################
