###################
##.......#.......##
##.#.###.#.###.#.##
##...............##
##.#.#..###..#.#.##
##...#...B...#...##
###..#.##-##.#..###
!......#IPC#......!
###..#.#####.#..###
##...............##
##...###.@.###...##
###..#...#...#..###
##.....#...#.....##
##.....#...#.....##
###################
